F 220,100,0
C 225,30,0

NO ./path_to_the_north_texture

SO ./path_to_the_south_texture
WE ./path_to_the_west_texture


EA ./path_to_the_east_texture


NO  0something111


111111111111111
1S0000000000011
10000111111011
100001    101
111111    111
1111111111111