

NO ./path_to_the_north_texture
SO ./path_to_the_south_texture
WE ./path_to_the_west_texture
EA ./path_to_the_east_texture



F 220,100,0
C 225,30,0

111111111111111
0S0000000000011
100001110111011
100001     101
100111     111
1000111111111
1000111    11
1000111    11
1111111    11