


F 0,0,0
C 225,225,225


NO ./textures/player.png
SO ./textures/p_player.png
WE ./textures/clue.png
EA ./textures/house.png





11111111
10000001
10000001
100N0001
11111111
