


F 220,100,0
C 225,225,225

NO ./textures/player.png

SO ./textures/player.png
WE ./textures/player.png


EA ./textures/player.png





111111111111111
111111111111111
111111111111111
1S0000000000011
100001111111011
100001     101
100111     111
1000111111111
1000111   111
1000111    11
1111111    11







